#############################   #############################
#                           #   #                           #
#                           #####                           #
#                                                           #
#                           #####                           #
#                           #	#                           #
#############################	#                           #
                                #                           #
                                #                           #
                                #                           #
                                #                           #
                                #############################